location::Online
level::Regular
date::2025_04_09
organizer::AlexSmirnov
players::generals
Олифер Егор :: Ludevic, Necrogenius :+: Tymna the Weaver
Токарев Александр :: Geist of Saint Traft
Яйлоян Евгений :: Glarb, Calamity's Augur
Орешкин Дмитрий :: Edric, Spymaster of Trest
Костин Андрей :: Plagon, Lord of the Beach
Лисин Дмитрий :: Phelia, Exuberant Shepherd
Бурмистров Павел :: Rograkh, Son of Rohgahh :+: Silas Renn, Seeker Adept
Байков Аркадий :: Vial Smasher the Fierce
Циулин Иван :: Tymna the Weaver :+: Kraum, Ludevic's Opus
Муравьев Роман :: Dihada, Binder of Wills
Поляков Герман :: Teferi, Temporal Archmage
Ревин Владимир :: Elenda, Saint of Dusk
Барабаш Валентин :: Ezio Auditore da Firenze
Курмакаев Игорь :: Grist, the Hunger Tide
Долганов Матвей :: Geist of Saint Traft
Антипин Костя :: Plagon, Lord of the Beach
Мещеряков Максим :: Thrasios, Triton Hero :+: Tymna the Weaver
Стрельцов Артем :: Thrasios, Triton Hero :+: Ardenn, Intrepid Archaeologist
Богданов Сергей :: Kroxa, Titan of Death's Hunger
Краснов Илья :: Ertai Resurrected
Поспелов Александр :: Ral, Monsoon Mage
Васильев Илья :: Eshki Dragonclaw
Сайфутдинов Тимур :: Bruse Tarl, Boorish Herder :+: Thrasios, Triton Hero
Матюнин Антон :: Inti, Seneschal of the Sun
Захаренко Вячеслав :: Skullbriar, the Walking Grave
Сомкин Константин :: Kotis, Sibsig Champion
Редько Павел :: Arabella, Abandoned Doll
Штофов Арсений :: Aminatou, the fateshifter
Скляров Филипп :: Aminatou, the Fateshifter
Воронцов Иван :: Surrak Dragonclaw
Плотников Александр :: Sai, Master Thopterist
Павликов Владислав :: Hidetsugu and Kairi
Сухов Никитка :: Azusa, Lost but Seeking
Лагерев Леонид :: Wilson, Refined Grizzly :+: Sword Coast Sailor
Козлов Максим :: Arahbo, Roar of the World
Шубенин Илья :: Malcolm, Alluring Scoundrel
Дартау Сергей :: Sheoldred, the Apocalypse
Rounds
https://aetherhub.com/Tourney/RoundTourney/38313